1 1 1 2 4 4 0 0 0 0 0 0 0 0 3 3 0 0 0 0 0 0 2 1 1
1 1 2 2 4 4 0 0 0 0 0 0 0 0 3 3 0 0 0 0 0 0 2 2 2
1 2 2 4 4 4 0 0 0 0 0 0 0 0 3 3 0 0 0 0 0 0 0 0 0
2 2 4 4 4 4 0 0 0 0 0 0 0 0 3 3 0 0 0 0 0 0 0 0 0
4 4 4 4 4 0 0 0 0 0 0 0 0 0 3 3 0 0 0 0 0 0 0 0 0
4 4 4 4 4 0 0 0 0 0 0 0 0 0 3 3 0 0 0 0 0 0 0 0 0
4 4 4 4 4 0 0 0 0 0 0 0 0 0 3 3 0 0 0 0 0 0 0 0 0
4 4 4 4 4 0 0 0 0 0 0 0 0 0 3 3 0 0 0 0 0 0 0 0 0
4 4 4 4 4 0 0 0 0 0 0 0 0 0 3 3 0 0 0 0 0 0 0 0 0
3 3 3 3 3 3 3 3 3 3 3 3 3 3 3 3 3 3 3 3 3 3 3 3 3
3 3 3 3 3 3 3 3 3 3 3 3 3 3 3 3 3 3 3 3 3 3 3 3 3
4 4 4 4 4 0 0 0 0 0 0 0 0 0 0 0 0 0 0 0 0 0 0 0 0
4 4 4 4 4 0 0 0 0 0 0 0 0 0 0 0 0 0 0 0 0 0 0 0 0
4 4 4 4 4 0 0 0 0 0 0 0 0 0 0 0 0 0 0 0 0 0 0 0 0
4 4 4 4 4 0 0 0 0 0 0 0 0 0 0 0 0 0 0 0 0 0 0 0 0
4 4 4 4 4 0 0 0 0 0 0 0 0 0 0 0 0 0 0 0 0 0 0 0 0
4 4 4 4 4 0 0 0 0 0 0 0 0 0 0 0 0 0 0 0 0 0 0 0 0
4 4 4 4 0 0 0 0 0 0 0 0 0 0 0 0 0 0 0 0 0 0 0 0 0
4 4 4 4 0 0 2 2 2 2 2 2 2 2 2 2 2 2 2 2 2 2 2 2 2
4 4 4 4 0 2 2 1 1 1 1 1 1 1 1 1 1 1 1 1 1 1 1 1 1
25 9 1 0 9
25 10 1 0 10
14 -1 3a 14 20
15 -1 3a 15 20