1 1 1 1 1 1 1 1 1 1 1 1 1 1 1 1 1 1 1 1 1 1 1 1 1
1 1 1 1 1 1 1 1 1 1 1 1 1 1 1 1 1 1 1 1 1 1 1 1 1
1 1 1 2 2 2 2 2 2 2 2 2 2 2 2 2 2 2 2 2 2 2 1 1 1
1 1 2 2 0 0 0 0 0 0 0 0 0 0 0 0 0 0 0 0 0 2 2 1 1
1 2 2 0 0 0 0 0 0 0 0 0 0 0 0 0 0 0 0 0 0 0 2 2 1
1 2 0 0 0 0 0 0 0 0 0 0 0 0 0 0 0 0 0 0 0 0 0 2 1
1 2 0 0 0 0 0 0 0 0 0 0 0 0 0 0 0 0 0 0 0 0 0 2 1
1 2 0 0 0 0 0 0 0 0 0 0 0 0 0 0 0 0 0 0 0 0 0 2 1
1 2 0 0 0 0 0 0 0 0 0 0 0 0 0 0 0 0 0 0 0 0 0 2 1
1 2 0 0 0 0 0 0 0 0 0 0 0 0 3 3 0 0 0 0 0 0 0 2 1
1 2 0 0 0 0 0 0 0 0 0 0 0 0 3 3 0 0 0 0 0 0 0 2 1
1 2 0 0 0 0 0 0 0 0 0 0 0 0 3 3 0 0 0 0 0 0 0 2 1
1 2 0 0 0 0 0 0 0 0 0 0 0 0 3 3 0 0 0 0 0 0 0 2 1
1 2 2 0 0 0 0 0 0 0 0 0 0 0 3 3 0 0 0 0 0 0 0 2 1
1 1 2 2 0 0 0 0 0 0 0 0 0 0 3 3 0 0 0 0 0 0 0 2 1
1 1 1 2 2 0 0 0 0 0 0 0 0 0 3 3 0 0 0 0 0 0 0 2 1
1 1 1 1 2 2 0 0 0 0 0 0 0 0 3 3 0 0 0 0 0 0 0 2 1
1 1 1 1 1 2 0 0 0 0 0 0 0 0 3 3 0 0 0 0 0 0 0 2 1
1 1 1 1 1 2 0 0 0 0 0 0 0 0 3 3 0 0 0 0 0 0 0 2 1
1 1 1 1 1 2 0 0 0 0 0 0 0 0 3 3 0 0 0 0 0 0 0 2 1
14 20 2 14 -1
15 20 2 15 -1